1111111111111
1001000000001
10C0011000001
1P0011E000001
1111111111111