1111111111111111111111111111111111
1E0000CCCCCCCCCC00000C000000000R01
1010010100100000101001000000010101
1010010010101R1CCC1001CCCCCCC10101
1P0000000CR0CRCCC00CRCCC0100CCRCC1
1111111111111111111111111111111111